WnnWnWWWWWWFWWW
WnnWnWWWWWWnWWW
WWnnnWnnnnnnWWW
WWWWnWnWWnWnnnW
SnWWnWnWWnWWWnW
nnWWnWnWWnWWWnW
WnWWnWWWWnnnWnn
WnnnnnnnWnWnWWW
WWWnWWWnnnWnWWW
WWWnWWWnWWWnWWW
WWnnnnnnWWWnWnn
WWnWWWWnWWWnWnn
WnnnWWWnnnnnWWn
WnnWWWWWWWWnnnn
WWnWWWWWWWWWWWW
