MxxMxMMMMMMAMMM
MxxMxMMMMMMxMMM
MMxxxMxxxxxxMMM
MMMMxMxMMxMxxxM
DxMMxMxMMxMMMxM
xxMMxMxMMxMMMxM
MxMMxMMMMxxxMxx
MxxxxxxxMxMxMMM
MMMxMMMxxxMxMMM
MMMxMMMxMMMxMMM
MMxxxxxxMMMxMxx
MMxMMMMxMMMxMxx
MxxxMMMxxxxxMMx
MxxMMMMMMMMxxxx
MMxMMMMMMMMMMMM
